INSERT INTO public.autocat_country(id, name) VALUES (1,	'Afghanistan');
INSERT INTO public.autocat_country(id, name) VALUES (2,	'Albania');
INSERT INTO public.autocat_country(id, name) VALUES (3,	'Algeria');
INSERT INTO public.autocat_country(id, name) VALUES (4,	'Andorra');
INSERT INTO public.autocat_country(id, name) VALUES (5,	'Angola');
INSERT INTO public.autocat_country(id, name) VALUES (6,	'Antigua and Barbuda');
INSERT INTO public.autocat_country(id, name) VALUES (7,	'Argentina');
INSERT INTO public.autocat_country(id, name) VALUES (8,	'Armenia');
INSERT INTO public.autocat_country(id, name) VALUES (9,	'Australia');
INSERT INTO public.autocat_country(id, name) VALUES (10,	'Austria');
INSERT INTO public.autocat_country(id, name) VALUES (11,	'Azerbaijan');
INSERT INTO public.autocat_country(id, name) VALUES (12,	'Bahamas');
INSERT INTO public.autocat_country(id, name) VALUES (13,	'Bahrain');
INSERT INTO public.autocat_country(id, name) VALUES (14,	'Bangladesh');
INSERT INTO public.autocat_country(id, name) VALUES (15,	'Barbados');
INSERT INTO public.autocat_country(id, name) VALUES (16,	'Belarus');
INSERT INTO public.autocat_country(id, name) VALUES (17,	'Belgium');
INSERT INTO public.autocat_country(id, name) VALUES (18,	'Belize');
INSERT INTO public.autocat_country(id, name) VALUES (19,	'Benin');
INSERT INTO public.autocat_country(id, name) VALUES (20,	'Bhutan');
INSERT INTO public.autocat_country(id, name) VALUES (21,	'Bolivia');
INSERT INTO public.autocat_country(id, name) VALUES (22,	'Bosnia and Herzegovina');
INSERT INTO public.autocat_country(id, name) VALUES (23,	'Botswana');
INSERT INTO public.autocat_country(id, name) VALUES (24,	'Brazil');
INSERT INTO public.autocat_country(id, name) VALUES (25,	'Brunei');
INSERT INTO public.autocat_country(id, name) VALUES (26,	'Bulgaria');
INSERT INTO public.autocat_country(id, name) VALUES (27,	'Burkina Faso');
INSERT INTO public.autocat_country(id, name) VALUES (28,	'Burundi');
INSERT INTO public.autocat_country(id, name) VALUES (29,	'CÃ´te dIvoire');
INSERT INTO public.autocat_country(id, name) VALUES (30,	'Cabo Verde');
INSERT INTO public.autocat_country(id, name) VALUES (31,	'Cambodia');
INSERT INTO public.autocat_country(id, name) VALUES (32,	'Cameroon');
INSERT INTO public.autocat_country(id, name) VALUES (33,	'Canada');
INSERT INTO public.autocat_country(id, name) VALUES (34,	'Central African Republic');
INSERT INTO public.autocat_country(id, name) VALUES (35,	'Chad');
INSERT INTO public.autocat_country(id, name) VALUES (36,	'Chile');
INSERT INTO public.autocat_country(id, name) VALUES (37,	'China');
INSERT INTO public.autocat_country(id, name) VALUES (38,	'Colombia');
INSERT INTO public.autocat_country(id, name) VALUES (39,	'Comoros');
INSERT INTO public.autocat_country(id, name) VALUES (40,	'Congo');
INSERT INTO public.autocat_country(id, name) VALUES (41,	'Costa Rica');
INSERT INTO public.autocat_country(id, name) VALUES (42,	'Croatia');
INSERT INTO public.autocat_country(id, name) VALUES (43,	'Cuba');
INSERT INTO public.autocat_country(id, name) VALUES (44,	'Cyprus');
INSERT INTO public.autocat_country(id, name) VALUES (45,	'Czechia');
INSERT INTO public.autocat_country(id, name) VALUES (46,	'Democratic Republic of the Congo');
INSERT INTO public.autocat_country(id, name) VALUES (47,	'Denmark');
INSERT INTO public.autocat_country(id, name) VALUES (48,	'Djibouti');
INSERT INTO public.autocat_country(id, name) VALUES (49,	'Dominica');
INSERT INTO public.autocat_country(id, name) VALUES (50,	'Dominican Republic');
INSERT INTO public.autocat_country(id, name) VALUES (51,	'Ecuador');
INSERT INTO public.autocat_country(id, name) VALUES (52,	'Egypt');
INSERT INTO public.autocat_country(id, name) VALUES (53,	'El Salvador');
INSERT INTO public.autocat_country(id, name) VALUES (54,	'Equatorial Guinea');
INSERT INTO public.autocat_country(id, name) VALUES (55,	'Eritrea');
INSERT INTO public.autocat_country(id, name) VALUES (56,	'Estonia');
INSERT INTO public.autocat_country(id, name) VALUES (57,	'Ethiopia');
INSERT INTO public.autocat_country(id, name) VALUES (58,	'Fiji');
INSERT INTO public.autocat_country(id, name) VALUES (59,	'Finland');
INSERT INTO public.autocat_country(id, name) VALUES (60,	'France');
INSERT INTO public.autocat_country(id, name) VALUES (61,	'Gabon');
INSERT INTO public.autocat_country(id, name) VALUES (62,	'Gambia');
INSERT INTO public.autocat_country(id, name) VALUES (63,	'Georgia');
INSERT INTO public.autocat_country(id, name) VALUES (64,	'Germany');
INSERT INTO public.autocat_country(id, name) VALUES (65,	'Ghana');
INSERT INTO public.autocat_country(id, name) VALUES (66,	'Greece');
INSERT INTO public.autocat_country(id, name) VALUES (67,	'Grenada');
INSERT INTO public.autocat_country(id, name) VALUES (68,	'Guatemala');
INSERT INTO public.autocat_country(id, name) VALUES (69,	'Guinea');
INSERT INTO public.autocat_country(id, name) VALUES (70,	'Guinea-Bissau');
INSERT INTO public.autocat_country(id, name) VALUES (71,	'Guyana');
INSERT INTO public.autocat_country(id, name) VALUES (72,	'Haiti');
INSERT INTO public.autocat_country(id, name) VALUES (73,	'Holy See');
INSERT INTO public.autocat_country(id, name) VALUES (74,	'Honduras');
INSERT INTO public.autocat_country(id, name) VALUES (75,	'Hungary');
INSERT INTO public.autocat_country(id, name) VALUES (76,	'Iceland');
INSERT INTO public.autocat_country(id, name) VALUES (77,	'India');
INSERT INTO public.autocat_country(id, name) VALUES (78,	'Indonesia');
INSERT INTO public.autocat_country(id, name) VALUES (79,	'Iran');
INSERT INTO public.autocat_country(id, name) VALUES (80,	'Iraq');
INSERT INTO public.autocat_country(id, name) VALUES (81,	'Ireland');
INSERT INTO public.autocat_country(id, name) VALUES (82,	'Israel');
INSERT INTO public.autocat_country(id, name) VALUES (83,	'Italy');
INSERT INTO public.autocat_country(id, name) VALUES (84,	'Jamaica');
INSERT INTO public.autocat_country(id, name) VALUES (85,	'Japan');
INSERT INTO public.autocat_country(id, name) VALUES (86,	'Jordan');
INSERT INTO public.autocat_country(id, name) VALUES (87,	'Kazakhstan');
INSERT INTO public.autocat_country(id, name) VALUES (88,	'Kenya');
INSERT INTO public.autocat_country(id, name) VALUES (89,	'Kiribati');
INSERT INTO public.autocat_country(id, name) VALUES (90,	'Kuwait');
INSERT INTO public.autocat_country(id, name) VALUES (91,	'Kyrgyzstan');
INSERT INTO public.autocat_country(id, name) VALUES (92,	'Laos');
INSERT INTO public.autocat_country(id, name) VALUES (93,	'Latvia');
INSERT INTO public.autocat_country(id, name) VALUES (94,	'Lebanon');
INSERT INTO public.autocat_country(id, name) VALUES (95,	'Lesotho');
INSERT INTO public.autocat_country(id, name) VALUES (96,	'Liberia');
INSERT INTO public.autocat_country(id, name) VALUES (97,	'Libya');
INSERT INTO public.autocat_country(id, name) VALUES (98,	'Liechtenstein');
INSERT INTO public.autocat_country(id, name) VALUES (99,	'Lithuania');
INSERT INTO public.autocat_country(id, name) VALUES (100,	'Luxembourg');
INSERT INTO public.autocat_country(id, name) VALUES (101,	'Madagascar');
INSERT INTO public.autocat_country(id, name) VALUES (102,	'Malawi');
INSERT INTO public.autocat_country(id, name) VALUES (103,	'Malaysia');
INSERT INTO public.autocat_country(id, name) VALUES (104,	'Maldives');
INSERT INTO public.autocat_country(id, name) VALUES (105,	'Mali');
INSERT INTO public.autocat_country(id, name) VALUES (106,	'Malta');
INSERT INTO public.autocat_country(id, name) VALUES (107,	'Marshall Islands');
INSERT INTO public.autocat_country(id, name) VALUES (108,	'Mauritania');
INSERT INTO public.autocat_country(id, name) VALUES (109,	'Mauritius');
INSERT INTO public.autocat_country(id, name) VALUES (110,	'Mexico');
INSERT INTO public.autocat_country(id, name) VALUES (111,	'Micronesia');
INSERT INTO public.autocat_country(id, name) VALUES (112,	'Moldova');
INSERT INTO public.autocat_country(id, name) VALUES (113,	'Monaco');
INSERT INTO public.autocat_country(id, name) VALUES (114,	'Mongolia');
INSERT INTO public.autocat_country(id, name) VALUES (115,	'Montenegro');
INSERT INTO public.autocat_country(id, name) VALUES (116,	'Morocco');
INSERT INTO public.autocat_country(id, name) VALUES (117,	'Mozambique');
INSERT INTO public.autocat_country(id, name) VALUES (118,	'Myanmar');
INSERT INTO public.autocat_country(id, name) VALUES (119,	'Namibia');
INSERT INTO public.autocat_country(id, name) VALUES (120,	'Nauru');
INSERT INTO public.autocat_country(id, name) VALUES (121,	'Nepal');
INSERT INTO public.autocat_country(id, name) VALUES (122,	'Netherlands');
INSERT INTO public.autocat_country(id, name) VALUES (123,	'New Zealand');
INSERT INTO public.autocat_country(id, name) VALUES (124,	'Nicaragua');
INSERT INTO public.autocat_country(id, name) VALUES (125,	'Niger');
INSERT INTO public.autocat_country(id, name) VALUES (126,	'Nigeria');
INSERT INTO public.autocat_country(id, name) VALUES (127,	'North Korea');
INSERT INTO public.autocat_country(id, name) VALUES (128,	'North Macedonia');
INSERT INTO public.autocat_country(id, name) VALUES (129,	'Norway');
INSERT INTO public.autocat_country(id, name) VALUES (130,	'Oman');
INSERT INTO public.autocat_country(id, name) VALUES (131,	'Pakistan');
INSERT INTO public.autocat_country(id, name) VALUES (132,	'Palau');
INSERT INTO public.autocat_country(id, name) VALUES (133,	'Palestine State');
INSERT INTO public.autocat_country(id, name) VALUES (134,	'Panama');
INSERT INTO public.autocat_country(id, name) VALUES (135,	'Papua New Guinea');
INSERT INTO public.autocat_country(id, name) VALUES (136,	'Paraguay');
INSERT INTO public.autocat_country(id, name) VALUES (137,	'Peru');
INSERT INTO public.autocat_country(id, name) VALUES (138,	'Philippines');
INSERT INTO public.autocat_country(id, name) VALUES (139,	'Poland');
INSERT INTO public.autocat_country(id, name) VALUES (140,	'Portugal');
INSERT INTO public.autocat_country(id, name) VALUES (141,	'Qatar');
INSERT INTO public.autocat_country(id, name) VALUES (142,	'Romania');
INSERT INTO public.autocat_country(id, name) VALUES (143,	'Russia');
INSERT INTO public.autocat_country(id, name) VALUES (144,	'Rwanda');
INSERT INTO public.autocat_country(id, name) VALUES (145,	'Saint Kitts and Nevis');
INSERT INTO public.autocat_country(id, name) VALUES (146,	'Saint Lucia');
INSERT INTO public.autocat_country(id, name) VALUES (147,	'Saint Vincent and the Grenadines');
INSERT INTO public.autocat_country(id, name) VALUES (148,	'Samoa');
INSERT INTO public.autocat_country(id, name) VALUES (149,	'San Marino');
INSERT INTO public.autocat_country(id, name) VALUES (150,	'Sao Tome and Principe');
INSERT INTO public.autocat_country(id, name) VALUES (151,	'Saudi Arabia');
INSERT INTO public.autocat_country(id, name) VALUES (152,	'Senegal');
INSERT INTO public.autocat_country(id, name) VALUES (153,	'Serbia');
INSERT INTO public.autocat_country(id, name) VALUES (154,	'Seychelles');
INSERT INTO public.autocat_country(id, name) VALUES (155,	'Sierra Leone');
INSERT INTO public.autocat_country(id, name) VALUES (156,	'Singapore');
INSERT INTO public.autocat_country(id, name) VALUES (157,	'Slovakia');
INSERT INTO public.autocat_country(id, name) VALUES (158,	'Slovenia');
INSERT INTO public.autocat_country(id, name) VALUES (159,	'Solomon Islands');
INSERT INTO public.autocat_country(id, name) VALUES (160,	'Somalia');
INSERT INTO public.autocat_country(id, name) VALUES (161,	'South Africa');
INSERT INTO public.autocat_country(id, name) VALUES (162,	'South Korea');
INSERT INTO public.autocat_country(id, name) VALUES (163,	'South Sudan');
INSERT INTO public.autocat_country(id, name) VALUES (164,	'Spain');
INSERT INTO public.autocat_country(id, name) VALUES (165,	'Sri Lanka');
INSERT INTO public.autocat_country(id, name) VALUES (166,	'Sudan');
INSERT INTO public.autocat_country(id, name) VALUES (167,	'Suriname');
INSERT INTO public.autocat_country(id, name) VALUES (168,	'Swaziland');
INSERT INTO public.autocat_country(id, name) VALUES (169,	'Sweden');
INSERT INTO public.autocat_country(id, name) VALUES (170,	'Switzerland');
INSERT INTO public.autocat_country(id, name) VALUES (171,	'Syria');
INSERT INTO public.autocat_country(id, name) VALUES (172,	'Tajikistan');
INSERT INTO public.autocat_country(id, name) VALUES (173,	'Tanzania');
INSERT INTO public.autocat_country(id, name) VALUES (174,	'Thailand');
INSERT INTO public.autocat_country(id, name) VALUES (175,	'Timor-Leste');
INSERT INTO public.autocat_country(id, name) VALUES (176,	'Togo');
INSERT INTO public.autocat_country(id, name) VALUES (177,	'Tonga');
INSERT INTO public.autocat_country(id, name) VALUES (178,	'Trinidad and Tobago');
INSERT INTO public.autocat_country(id, name) VALUES (179,	'Tunisia');
INSERT INTO public.autocat_country(id, name) VALUES (180,	'Turkey');
INSERT INTO public.autocat_country(id, name) VALUES (181,	'Turkmenistan');
INSERT INTO public.autocat_country(id, name) VALUES (182,	'Tuvalu');
INSERT INTO public.autocat_country(id, name) VALUES (183,	'Uganda');
INSERT INTO public.autocat_country(id, name) VALUES (184,	'Ukraine');
INSERT INTO public.autocat_country(id, name) VALUES (185,	'United Arab Emirates');
INSERT INTO public.autocat_country(id, name) VALUES (186,	'United Kingdom');
INSERT INTO public.autocat_country(id, name) VALUES (187,	'United States of America');
INSERT INTO public.autocat_country(id, name) VALUES (188,	'Uruguay');
INSERT INTO public.autocat_country(id, name) VALUES (189,	'Uzbekistan');
INSERT INTO public.autocat_country(id, name) VALUES (190,	'Vanuatu');
INSERT INTO public.autocat_country(id, name) VALUES (191,	'Venezuela');
INSERT INTO public.autocat_country(id, name) VALUES (192,	'Vietnam');
INSERT INTO public.autocat_country(id, name) VALUES (193,	'Yemen');
INSERT INTO public.autocat_country(id, name) VALUES (194,	'Zambia');
INSERT INTO public.autocat_country(id, name) VALUES (195,	'Zimbabwe');